XNXSNXXNX
NSFX#SFXS
SNX   XNS
XNS   SFX
N#X   N#F
SFN   XNS
NSX   SXN
XSN   NSX
XSFNSXFNS
XSXNFXSNX
