##XXXNXNX
 FSXX XXN
XXFSXSXFX
 XXXXFXXX
 XSF XXNS
XSXSXX NX
XSXSXXFF
FSFxX
NXxNSXX
XSS
