NSS   FSN
XSFNXSNNX
SNS   SXN
 XX   NN
  NXSXS
  SXNXN
 SN   XX
NNS   SNX
XFSNXNFSX
XXN   NSF
